GER	= "countries/sovereign/Germany.txt"
ENG = "countries/sovereign/United Kingdom.txt"
SOV = "countries/sovereign/Soviet Union.txt"
SWE	= "countries/sovereign/Sweden.txt"
FRA	= "countries/sovereign/France.txt"
LUX	= "countries/sovereign/Luxemburg.txt"
BEL	= "countries/sovereign/Belgium.txt"
HOL	= "countries/sovereign/Holland.txt"
CZE	= "countries/sovereign/Czechoslovakia.txt"
POL	= "countries/sovereign/Poland.txt"
AUS	= "countries/sovereign/Austria.txt"
LIT	= "countries/sovereign/Lithuania.txt"
EST	= "countries/sovereign/Estonia.txt"
LAT	= "countries/sovereign/Latvia.txt"
SPR = "countries/sovereign/Spain.txt"
ITA = "countries/sovereign/Italy.txt"
ROM = "countries/sovereign/Romania.txt"
SER = "countries/sovereign/Serbia.txt"
SWI = "countries/sovereign/Switzerland.txt"
TUR = "countries/sovereign/Turkey.txt"
GRE = "countries/sovereign/Greece.txt"
ALB = "countries/sovereign/Albania.txt"
NOR = "countries/sovereign/Norway.txt"
DEN = "countries/sovereign/Denmark.txt"
BUL = "countries/sovereign/Bulgaria.txt"
POR = "countries/sovereign/Portugal.txt"
FIN = "countries/sovereign/Finland.txt"
IRE = "countries/sovereign/Ireland.txt"
HUN = "countries/sovereign/Hungary.txt"
AFG = "countries/sovereign/Afghanistan.txt"
ARG = "countries/sovereign/Argentina.txt"
AST = "countries/sovereign/Australia.txt"
BHU = "countries/sovereign/Bhutan.txt"
BOL = "countries/sovereign/Bolivia.txt"
BRA = "countries/sovereign/Brazil.txt"
CAN = "countries/sovereign/Canada.txt"
CHI = "countries/sovereign/China.txt"
CHL = "countries/sovereign/Chile.txt"
COL = "countries/sovereign/Colombia.txt"
COS = "countries/sovereign/Costa Rica.txt"
ECU = "countries/sovereign/Ecuador.txt"
ELS = "countries/sovereign/El Salvador.txt"
ETH = "countries/sovereign/Ethiopia.txt"
GUA = "countries/sovereign/Guatemla.txt"
HON = "countries/sovereign/Honduras.txt"
IRQ = "countries/sovereign/Iraq.txt"
JAP = "countries/sovereign/Japan.txt"
KOR = "countries/sovereign/Korea.txt"
LIB = "countries/sovereign/Liberia.txt"
MEX = "countries/sovereign/Mexico.txt"
NEP = "countries/sovereign/Nepal.txt"
NIC = "countries/sovereign/Nicaragua.txt"
NZL = "countries/sovereign/New Zealand.txt"
PAN = "countries/sovereign/Panama.txt"
PER = "countries/sovereign/Persia.txt"
PHI = "countries/sovereign/Philippines.txt"
PRU = "countries/sovereign/Peru.txt"
SAF = "countries/sovereign/South Africa.txt"
SAU = "countries/sovereign/Saudi Arabia.txt"
SIA = "countries/sovereign/Siam.txt"
TIB = "countries/sovereign/Tibet.txt"
URG = "countries/sovereign/Uruguay.txt"
VEN = "countries/sovereign/Venezula.txt"
USA = "countries/sovereign/USA.txt"
MON = "countries/sovereign/Mongolia.txt"
PAR = "countries/sovereign/Paraguay.txt"
CUB = "countries/sovereign/Cuba.txt"
DOM = "countries/sovereign/Dominican Republic.txt"
HAI = "countries/sovereign/Haiti.txt"
YEM = "countries/sovereign/Yeman.txt"
OMA = "countries/sovereign/Oman.txt"
SLO = "countries/sovereign/Slovakia.txt"
IND = "countries/sovereign/India.txt"
CRO = "countries/sovereign/Croatia.txt"
PRC = "countries/sovereign/ComChina.txt"
ICE = "countries/sovereign/Iceland.txt"
LEB = "countries/sovereign/Lebanon.txt"
JOR = "countries/sovereign/Jordan.txt"
SYR = "countries/sovereign/Syria.txt"
EGY = "countries/sovereign/Egypt.txt"
LBA = "countries/sovereign/Libya.txt"
ISR = "countries/sovereign/Israel.txt"
VIN = "countries/sovereign/Vietnam.txt"
CAM = "countries/sovereign/Cambodia.txt"
MAL = "countries/sovereign/Malaysia.txt"
INS = "countries/sovereign/Indonesia.txt"
LAO = "countries/sovereign/Laos.txt"
MNT = "countries/sovereign/Montenegro.txt"
UKR = "countries/sovereign/Ukraine.txt"
GEO = "countries/sovereign/Georgia.txt"
KAZ = "countries/sovereign/Kazakhstan.txt" 
AZR = "countries/sovereign/Azerbaijan.txt"
ARM = "countries/sovereign/Armenia.txt"
BLR = "countries/sovereign/Belarus.txt"
ANG = "countries/sovereign/Angola.txt"
MZB = "countries/sovereign/Mozambique.txt"
ZIM = "countries/sovereign/Zimbabwe.txt"
COG = "countries/sovereign/Congo.txt"
KEN = "countries/sovereign/Kenya.txt"
PAK = "countries/sovereign/Pakistan.txt"
BOT = "countries/sovereign/Botswana.txt"
MAN = "countries/sovereign/Manchukou.txt"
BAH = "countries/sovereign/Bahamas.txt"
BAN = "countries/sovereign/Bangladesh.txt"
BLZ = "countries/sovereign/Belize.txt"
BRM = "countries/sovereign/Burma.txt"
GYA = "countries/sovereign/Guyana.txt"
JAM = "countries/sovereign/Jamaica.txt"
KYR = "countries/sovereign/Kyrgyzstan.txt"
MAD = "countries/sovereign/Madagascar.txt"
MOL = "countries/sovereign/Moldova.txt"
PNG = "countries/sovereign/Papua New Guinea.txt"
QAT = "countries/sovereign/Qatar.txt"
SRL = "countries/sovereign/Sri Lanka.txt"
SUR = "countries/sovereign/Suriname.txt"
TAJ = "countries/sovereign/Tajikistan.txt"
TRI = "countries/sovereign/Trinidad and Tobago.txt"
TMS = "countries/sovereign/Turkmenistan.txt"
UAE = "countries/sovereign/United Arab Emirates.txt"
UZB = "countries/sovereign/Uzbekistan.txt"
KUW = "countries/sovereign/Kuwait.txt"
CYP = "countries/sovereign/Cyprus.txt"
MLT = "countries/sovereign/Malta.txt"
ALG = "countries/sovereign/Algeria.txt"
MOR = "countries/sovereign/Morocco.txt"
TUN = "countries/sovereign/Tunisia.txt"
SUD = "countries/sovereign/Sudan.txt"
ERI = "countries/sovereign/Eritrea.txt"
DJI = "countries/sovereign/Djibouti.txt"
SOM = "countries/sovereign/Somalia.txt"
UGA = "countries/sovereign/Uganda.txt"
RWA = "countries/sovereign/Rwanda.txt"
BRD = "countries/sovereign/Burundi.txt"
TZN = "countries/sovereign/Tanzania.txt"
ZAM = "countries/sovereign/Zambia.txt"
MLW = "countries/sovereign/Malawi.txt"
GAB = "countries/sovereign/Gabon.txt"
RCG = "countries/sovereign/Republic of Congo.txt"
EQG = "countries/sovereign/Equatorial Guinea.txt"
CMR = "countries/sovereign/Cameroon.txt"
CAR = "countries/sovereign/Central African Republic.txt"
CHA = "countries/sovereign/Chad.txt"
NGA = "countries/sovereign/Nigeria.txt"
DAH = "countries/sovereign/Dahomey.txt"
TOG = "countries/sovereign/Togo.txt"
GHA = "countries/sovereign/Ghana.txt"
IVO = "countries/sovereign/Ivory Coast.txt"
VOL = "countries/sovereign/Upper Volta.txt"
MLI = "countries/sovereign/Mali.txt"
SIE = "countries/sovereign/Sierra Leone.txt"
GNA = "countries/sovereign/Guinea.txt"
GNB = "countries/sovereign/Guinea-Bissau.txt"
SEN = "countries/sovereign/Senegal.txt"
GAM = "countries/sovereign/Gambia.txt"
NGR = "countries/sovereign/Niger.txt"
MRT = "countries/sovereign/Mauritania.txt"
NMB = "countries/sovereign/Namibia.txt"
BAS = "countries/sovereign/British Antilles.txt"
CAY = "countries/sovereign/Cayenne.txt"
MLD = "countries/sovereign/Maldives.txt"
FIJ = "countries/sovereign/Fiji.txt"
TAH = "countries/sovereign/Tahiti.txt"
GUM = "countries/sovereign/Guam.txt"
SOL = "countries/sovereign/Solomon.txt"
SAM = "countries/sovereign/Samoa.txt"
SLV = "countries/sovereign/Slovenia.txt"
BOS = "countries/sovereign/Bosnia.txt"
MAC = "countries/sovereign/Macedonia.txt"
#Dead
GXC = "countries/sovereign/Guangxi.txt"
SHX = "countries/sovereign/Shanxi.txt"
XSM = "countries/sovereign/Xibei San Ma.txt"
MEN = "countries/sovereign/Mengkukuo.txt"
SIK = "countries/sovereign/Sinkiang.txt"
YUG = "countries/sovereign/Yugoslavia.txt"
WGR = "countries/sovereign/West Germany.txt"
DDR = "countries/sovereign/East Germany.txt"

#Rebels or Breakaways or non sovereign nations
WES = "countries/Rebel/Western Sahara.txt"
NIR = "countries/Rebel/Northern Ireland.txt"
BAY = "countries/Rebel/Bavaria.txt"
MEK = "countries/Rebel/Mecklenburg.txt"
PRE = "countries/Rebel/Prussia.txt"
SAX = "countries/Rebel/Saxony.txt"
HAN = "countries/Rebel/Hanover.txt"
WUR = "countries/Rebel/Wurtemberg.txt"
SHL = "countries/Rebel/Schleswig-Holstein.txt"
CAT = "countries/Rebel/Catalonia.txt"
NAV = "countries/Rebel/Navarra.txt"
GLC = "countries/Rebel/Galicia.txt"
ADU = "countries/Rebel/Andalusia.txt"
BRI = "countries/Rebel/Brittany.txt"
OCC = "countries/Rebel/Occitania.txt"
COR = "countries/Rebel/Corsica.txt"
CSA = "countries/Rebel/CSA.txt"
USB = "countries/Rebel/USB.txt"#neutral US bloc during civil war in MTG
CRC = "countries/Rebel/Curacao.txt"
GDL = "countries/Rebel/Guadeloupe.txt"
PAL = "countries/Rebel/Palestine.txt"
HAW = "countries/Rebel/Hawaii.txt"
TAN = "countries/Rebel/Tannu Tuva.txt"
PUE = "countries/Rebel/Puerto Rico.txt"
SCO = "countries/Rebel/Scotland.txt"
WLS = "countries/Rebel/Wales.txt"
YUN = "countries/Rebel/Yunnan.txt"