#New Nations
# = "countries/sovereign/ "
AND = "countries/sovereign/Andorra.txt"
ANT = "countries/sovereign/Antigua_Barbuda.txt"
BRH = "countries/sovereign/Bahrain.txt"
BAR = "countries/sovereign/Barbados.txt"
CAP = "countries/sovereign/Cape_Verde.txt"
COM = "countries/sovereign/Comoros.txt"
DOC = "countries/sovereign/Dominica.txt"
ETI = "countries/sovereign/East_Timor.txt"
ESW = "countries/sovereign/Eswatini.txt"
GRN = "countries/sovereign/Grenada.txt"
KIR = "countries/sovereign/Kiribati.txt"
NKR = "countries/sovereign/North_Korea.txt"
SKR = "countries/sovereign/South_Korea.txt"
LES = "countries/sovereign/Lesotho.txt"
LIE = "countries/sovereign/Liechtenstein.txt"
MAR = "countries/sovereign/Marshall_Islands.txt"
MIC = "countries/sovereign/Micronesia.txt"
MOC = "countries/sovereign/Monaco.txt"
NAU = "countries/sovereign/Nauru.txt"
PAU = "countries/sovereign/Palau.txt"
SAN = "countries/sovereign/Saint_Kitts_and_Nevis.txt"
SAL = "countries/sovereign/Saint_Lucia.txt"
SAV = "countries/sovereign/Saint_Vincent.txt"
SNM = "countries/sovereign/San_Marino.txt"
SAO = "countries/sovereign/Sao_Tome.txt"
SEY = "countries/sovereign/Seychelles.txt"
SIN = "countries/sovereign/Singapore.txt"
SSD = "countries/sovereign/South_Sudan.txt"
TON = "countries/sovereign/Tonga.txt"
TUV = "countries/sovereign/Tuvalu.txt"
VAN = "countries/sovereign/Vanuatu.txt"
MAU = "countries/sovereign/Mauritius.txt"
#Rebels or Breakaways or non sovereign nations
ABK = "countries/Rebel/Abkhazia.txt"
ART = "countries/Rebel/Artsakh.txt"
KOS = "countries/Rebel/Kosovo.txt"
NIU = "countries/Rebel/Niue.txt"
NCY = "countries/Rebel/Northern_Cyprus.txt"
SML = "countries/Rebel/Somaliland.txt"
SOS = "countries/Rebel/South_Ossetia.txt"
#Supernations
EUR = "countries/Supernations/Europe.txt"
UNI = "countries/Supernations/United_Nations.txt"
IST = "countries/Supernations/Islamic_States.txt"