#New Nations
# = "countries/ "
AND = "countries/Andorra.txt"
ANT = "countries/Antigua_Barbuda.txt"
BRH = "countries/Bahrain.txt"
BAR = "countries/Barbados.txt"
CAP = "countries/Cape_Verde.txt"
COM = "countries/Comoros.txt"
ETI = "countries/East_Timor.txt"
ESW = "countries/Eswatini.txt"
GRN = "countries/Grenada.txt"
KIR = "countries/Kiribati.txt"
NKR = "countries/North_Korea.txt"
SKR = "countries/South_Korea.txt"
LES = "countries/Lesotho.txt"
LIE = "countries/Liechtenstein.txt"
MAR = "countries/Marshall_Islands.txt"
MIC = "countries/Micronesia.txt"
MOC = "countries/Monaco.txt"
NAU = "countries/Nauru.txt"
PAU = "countries/Palau.txt"
SAN = "countries/Saint_Kitts_and_Nevis.txt"
SAL = "countries/Saint_Lucia.txt"
SAV = "countries/Saint_Vincent.txt"
SNM = "countries/San_Marino.txt"
SAO = "countries/Sao_Tome.txt"
SEY = "countries/Seychelles.txt"
SIN = "countries/Singapore.txt"
SSD = "countries/South_Sudan.txt"
TON = "countries/Tonga.txt"
TUV = "countries/Tuvalu.txt"
VAN = "countries/Vanuatu.txt"
MAU = "countries/Mauritius.txt"
#Rebel Nations

ABK = "countries/Abkhazia.txt"
ART = "countries/Artsakh.txt"
KOS = "countries/Kosovo.txt"
NIU = "countries/Niue.txt"
NCY = "countries/Northern_Cyprus.txt"
SML = "countries/Somaliland.txt"
SOS = "countries/South_Ossetia.txt"
#Supernations
EUR = "countries/Europe.txt"
UNI = "countries/United_Nations.txt"
IST = "countries/Islamic_States.txt"